Wynter|David|Dalton
Nicholas|Farmer|Gregory
Laith|White|Kinney
Rigel|Rogers|Joyner
Riley|Fry|Berg
Brennan|Fernandez|Luna
Sonya|Conner|Hubbard
Clementine|Richmond|Dodson
Aquila|Strong|Valdez
Lana|Shepherd|Kinney
Geraldine|Pickett|Lambert
Candace|Barton|Benton
Colleen|Stone|Solomon
Leslie|Mcfarland|Gross
Ursa|Hurst|Cote
Rigel|Jordan|Bailey
Thor|Hoffman|Gardner
Lamar|Burks|Short
Jamal|Cameron|Mays
Troy|Mckee|Jacobs
Heidi|Nicholson|Rollins
Jaquelyn|Stein|Shannon
Katell|Wilcox|Ballard
Portia|Carver|Camacho
Macey|Craig|Peterson
Uma|Le|Gilbert
Halee|Ortega|Randolph
Yasir|Bennett|Griffin
Lars|Stokes|Hewitt
Kato|Mccray|Curry
Rina|Potter|Grimes
Jolie|Cunningham|Quinn
Yoshi|Gray|Dawson
Hyatt|Knowles|Weaver
Caldwell|Horn|Dickson
Cara|Gibbs|Donaldson
Callum|Holcomb|Ross
Carl|Hobbs|Conway
Edward|Kerr|Lawrence
Cooper|Grant|Tucker
Nero|George|Curtis
Brendan|Harrell|Casey
Noelani|Norton|Levy
Lee|Cain|Wilcox
Cruz|Maddox|Sears
Carolyn|Lucas|Barry
Channing|Norris|Cross
Idola|Gates|Justice
Orla|Aguirre|Morrow
Josiah|Levine|Carver
Dawn|Juarez|Witt
Malachi|Myers|Hartman
Amos|Moody|Buchanan
Mariko|Frost|Horton
Nehru|Pruitt|Kennedy
Reuben|Levy|Chase
Madeline|Hutchinson|Kelley
Cedric|Donaldson|Oliver
Justine|Leon|Davidson
Malik|Reynolds|Robertson
Burke|Harrell|Ashley
Rosalyn|Meadows|Rice
Ray|Baxter|Fuentes
Merritt|Middleton|Davenport
Fulton|England|Pacheco
Aretha|Finley|Huber
Jamal|Massey|Roth
Quin|Nolan|Harrison
Raphael|Huber|Stephens
Alvin|Mccormick|Wong
Blaze|Houston|Lambert
Tatyana|Rowland|Benton
Ivy|Rutledge|Sweeney
Josephine|Walters|Hicks
Fleur|Fleming|Jenkins
Winifred|Gardner|Ewing
Halee|Hawkins|Burris
Adele|Franks|Hodges
David|Kirkland|Salinas
Kane|Atkinson|Rowland
Thomas|Bishop|Fuentes
Geraldine|Potter|Myers
Jaime|Camacho|Bentley
Macon|Avery|Monroe
Justin|Gregory|Oneal
Madeline|Soto|Byrd
Ora|Garcia|Atkinson
Farrah|Ross|Cherry
Pamela|Barrera|Snyder
Akeem|Nichols|Peters
Ginger|Hartman|Farrell
Alana|Hull|Marshall
Gray|Medina|Pickett
Dylan|Ramos|Morin
Ima|Lester|Daugherty
Erasmus|Mccray|Golden
Wynter|Frye|Kramer
Jana|Mcconnell|Tate
Phyllis|Marshall|Mcgowan
Jade|Christian|Harris
